||||||||||||||||||||||||||||
|............||............|
|.||||.|||||.||.|||||.||||.|
|o||||.|||||.||.|||||.||||o|
|.||||.|||||.||.|||||.||||.|
|..........................|
|.||||.||.||||||||.||.||||.|
|.||||.||.||||||||.||.||||.|
|......||....||....||......|
||||||.||||| || |||||.||||||
||||||.||||| || |||||.||||||
||||||.||          ||.||||||
||||||.|| |||  ||| ||.||||||
||||||.|| |      | ||.||||||
      .   |      |   .      
||||||.|| |      | ||.||||||
||||||.|| |||||||| ||.||||||
||||||.||          ||.||||||
||||||.|| |||||||| ||.||||||
||||||.|| |||||||| ||.||||||
|............||............|
|.||||.|||||.||.|||||.||||.|
|.||||.|||||.||.|||||.||||.|
|o..||.......  .......||..o|
|||.||.||.||||||||.||.||.|||
|||.||.||.||||||||.||.||.|||
|......||....||....||......|
|.||||||||||.||.||||||||||.|
|.||||||||||.||.||||||||||.|
|..........................|
||||||||||||||||||||||||||||